█████████████████████████████
█ P         █    $          █
█           █  $$           █
█           ████████        █
█       █                   █
█       █           B       █
█       █                   █
███d█████████████████████████