█████████████████████████████
█           █    $          █
█           █  $$           █
█           ████████        █
█       █                   █
█       █           B       █
█       █                   █
███d█████████████████████████